granularity_geo,location_name,date,new_dose_1,new_dose_2,total_dose_1,total_dose_2,total_pr100_dose_1,total_pr100_dose_2,new_doses,total_doses,source
county,Oslo,2020-12-27,5,0,5,0,0.00072098677133472,0.0,5,5,fhi:git
county,Oslo,2020-12-28,264,0,269,0,0.0387890882978079,0.0,264,269,fhi:git
county,Oslo,2020-12-29,118,0,387,0,0.0558043761013073,0.0,118,387,fhi:git
county,Oslo,2020-12-30,58,0,445,0,0.06416782264879001,0.0,58,445,fhi:git
county,Oslo,2020-12-31,5,0,450,0,0.0648888094201248,0.0,5,450,fhi:git
county,Oslo,2021-01-01,6,0,456,0,0.0657539935457264,0.0,6,456,fhi:git
county,Oslo,2021-01-02,0,0,456,0,0.0657539935457264,0.0,0,456,fhi:git
county,Oslo,2021-01-03,0,0,456,0,0.0657539935457264,0.0,0,456,fhi:git
county,Oslo,2021-01-04,0,0,456,0,0.0657539935457264,0.0,0,456,fhi:git
county,Oslo,2021-01-05,480,0,936,0,0.13496872359386,0.0,480,936,fhi:git
county,Oslo,2021-01-06,605,0,1541,0,0.22220812292536102,0.0,605,1541,fhi:git
county,Oslo,2021-01-07,967,0,2508,0,0.36164696450149497,0.0,967,2508,fhi:git
county,Oslo,2021-01-08,449,0,2957,0,0.42639157656735294,0.0,449,2957,fhi:git
county,Oslo,2021-01-09,126,0,3083,0,0.44456044320498794,0.0,126,3083,fhi:git
county,Oslo,2021-01-10,100,0,3183,0,0.458980178631683,0.0,100,3183,fhi:git
county,Oslo,2021-01-11,76,0,3259,0,0.46993917755597,0.0,76,3259,fhi:git
county,Oslo,2021-01-12,239,0,3498,0,0.50440234522577,0.0,239,3498,fhi:git
county,Oslo,2021-01-13,488,0,3986,0,0.574770654108038,0.0,488,3986,fhi:git
county,Oslo,2021-01-14,1231,0,5217,0,0.752277597210646,0.0,1231,5217,fhi:git
county,Oslo,2021-01-15,1654,0,6871,0,0.9907800211681721,0.0,1654,6871,fhi:git
county,Oslo,2021-01-16,632,0,7503,0,1.08191274906488,0.0,632,7503,fhi:git
county,Oslo,2021-01-17,277,5,7780,5,1.1218554161968202,0.00072098677133472,282,7785,fhi:git
county,Oslo,2021-01-18,739,231,8519,236,1.2284172610001,0.0340305756069988,970,8755,fhi:git
county,Oslo,2021-01-19,807,69,9326,305,1.34478452589352,0.0439801930514179,876,9631,fhi:git
county,Oslo,2021-01-20,985,99,10311,404,1.4868189198464599,0.0582557311238453,1084,10715,fhi:git
county,Oslo,2021-01-21,1012,21,11323,425,1.6327466423646102,0.0612838755634512,1033,11748,fhi:git
county,Oslo,2021-01-22,667,6,11990,431,1.7289262776606598,0.0621490596890528,673,12421,fhi:git
county,Oslo,2021-01-23,232,0,12222,431,1.76238006385059,0.0621490596890528,232,12653,fhi:git
county,Oslo,2021-01-24,65,0,12287,431,1.77175289187794,0.0621490596890528,65,12718,fhi:git
county,Oslo,2021-01-25,257,0,12544,431,1.80881161192454,0.0621490596890528,257,12975,fhi:git
county,Oslo,2021-01-26,278,402,12822,833,1.84889847641075,0.120116396104364,680,13655,fhi:git
county,Oslo,2021-01-27,965,524,13787,1357,1.98804892327836,0.19567580974024298,1489,15144,fhi:git
county,Oslo,2021-01-28,812,841,14599,2198,2.1051371749431103,0.316945784678743,1653,16797,fhi:git
county,Oslo,2021-01-29,366,500,14965,2698,2.1579134066048202,0.389044461812215,866,17663,fhi:git
county,Oslo,2021-01-30,78,147,15043,2845,2.16916080023764,0.410241472889456,225,17888,fhi:git
county,Oslo,2021-01-31,60,44,15103,2889,2.1778126414936496,0.416586156477201,104,17992,fhi:git
county,Oslo,2021-02-01,51,46,15154,2935,2.18516670656127,0.42321923477348,97,18089,fhi:git
county,Oslo,2021-02-02,1440,147,16594,3082,2.39281089670567,0.444416245850721,1587,19676,fhi:git
county,Rogaland,2020-12-27,0,0,0,0,0.0,0.0,0,0,fhi:git
county,Rogaland,2020-12-28,0,0,0,0,0.0,0.0,0,0,fhi:git
county,Rogaland,2020-12-29,0,0,0,0,0.0,0.0,0,0,fhi:git
county,Rogaland,2020-12-30,0,0,0,0,0.0,0.0,0,0,fhi:git
county,Rogaland,2020-12-31,0,0,0,0,0.0,0.0,0,0,fhi:git
county,Rogaland,2021-01-01,0,0,0,0,0.0,0.0,0,0,fhi:git
county,Rogaland,2021-01-02,0,0,0,0,0.0,0.0,0,0,fhi:git
county,Rogaland,2021-01-03,0,0,0,0,0.0,0.0,0,0,fhi:git
county,Rogaland,2021-01-04,0,0,0,0,0.0,0.0,0,0,fhi:git
county,Rogaland,2021-01-05,548,0,548,0,0.11419235994765499,0.0,548,548,fhi:git
county,Rogaland,2021-01-06,641,0,1189,0,0.24776408025139,0.0,641,1189,fhi:git
county,Rogaland,2021-01-07,210,0,1399,0,0.291523926216732,0.0,210,1399,fhi:git
county,Rogaland,2021-01-08,21,0,1420,0,0.295899910813266,0.0,21,1420,fhi:git
county,Rogaland,2021-01-09,0,0,1420,0,0.295899910813266,0.0,0,1420,fhi:git
county,Rogaland,2021-01-10,0,0,1420,0,0.295899910813266,0.0,0,1420,fhi:git
county,Rogaland,2021-01-11,1,0,1421,0,0.296108291032149,0.0,1,1421,fhi:git
county,Rogaland,2021-01-12,129,0,1550,0,0.32298933926800205,0.0,129,1550,fhi:git
county,Rogaland,2021-01-13,760,0,2310,0,0.481358305618764,0.0,760,2310,fhi:git
county,Rogaland,2021-01-14,523,0,2833,0,0.590341160094355,0.0,523,2833,fhi:git
county,Rogaland,2021-01-15,288,0,3121,0,0.650354663132538,0.0,288,3121,fhi:git
county,Rogaland,2021-01-16,0,0,3121,0,0.650354663132538,0.0,0,3121,fhi:git
county,Rogaland,2021-01-17,0,0,3121,0,0.650354663132538,0.0,0,3121,fhi:git
county,Rogaland,2021-01-18,71,0,3192,0,0.6651496586732011,0.0,71,3192,fhi:git
county,Rogaland,2021-01-19,511,0,3703,0,0.7716319505222009,0.0,511,3703,fhi:git
county,Rogaland,2021-01-20,616,0,4319,0,0.899994165353871,0.0,616,4319,fhi:git
county,Rogaland,2021-01-21,423,0,4742,0,0.988138997941203,0.0,423,4742,fhi:git
county,Rogaland,2021-01-22,266,0,5008,0,1.04356813616397,0.0,266,5008,fhi:git
county,Rogaland,2021-01-23,0,0,5008,0,1.04356813616397,0.0,0,5008,fhi:git
county,Rogaland,2021-01-24,0,0,5008,0,1.04356813616397,0.0,0,5008,fhi:git
county,Rogaland,2021-01-25,148,0,5156,0,1.0744084085585899,0.0,148,5156,fhi:git
county,Rogaland,2021-01-26,335,381,5491,381,1.14421578188426,0.0793928633942637,716,5872,fhi:git
county,Rogaland,2021-01-27,819,599,6310,980,1.31487918114909,0.20421261450493,1418,7290,fhi:git
county,Rogaland,2021-01-28,502,282,6812,1262,1.41948605102815,0.26297583622981796,784,8074,fhi:git
county,Rogaland,2021-01-29,395,22,7207,1284,1.5017962374867702,0.267560201045235,417,8491,fhi:git
county,Rogaland,2021-01-30,2,0,7209,1284,1.50221299792453,0.267560201045235,2,8493,fhi:git
county,Rogaland,2021-01-31,0,0,7209,1284,1.50221299792453,0.267560201045235,0,8493,fhi:git
county,Rogaland,2021-02-01,13,5,7222,1289,1.50492194077001,0.268602102139648,18,8511,fhi:git
county,Rogaland,2021-02-02,338,72,7560,1361,1.57535445475232,0.283605477899194,410,8921,fhi:git
county,Møre og Romsdal,2020-12-27,0,0,0,0,0.0,0.0,0,0,fhi:git
county,Møre og Romsdal,2020-12-28,0,0,0,0,0.0,0.0,0,0,fhi:git
county,Møre og Romsdal,2020-12-29,0,0,0,0,0.0,0.0,0,0,fhi:git
county,Møre og Romsdal,2020-12-30,0,0,0,0,0.0,0.0,0,0,fhi:git
county,Møre og Romsdal,2020-12-31,0,0,0,0,0.0,0.0,0,0,fhi:git
county,Møre og Romsdal,2021-01-01,0,0,0,0,0.0,0.0,0,0,fhi:git
county,Møre og Romsdal,2021-01-02,0,0,0,0,0.0,0.0,0,0,fhi:git
county,Møre og Romsdal,2021-01-03,0,0,0,0,0.0,0.0,0,0,fhi:git
county,Møre og Romsdal,2021-01-04,0,0,0,0,0.0,0.0,0,0,fhi:git
county,Møre og Romsdal,2021-01-05,186,0,186,0,0.0701256984293352,0.0,186,186,fhi:git
county,Møre og Romsdal,2021-01-06,497,0,683,0,0.257504580791591,0.0,497,683,fhi:git
county,Møre og Romsdal,2021-01-07,457,0,1140,0,0.429802667792699,0.0,457,1140,fhi:git
county,Møre og Romsdal,2021-01-08,35,0,1175,0,0.442998363733703,0.0,35,1175,fhi:git
county,Møre og Romsdal,2021-01-09,0,0,1175,0,0.442998363733703,0.0,0,1175,fhi:git
county,Møre og Romsdal,2021-01-10,0,0,1175,0,0.442998363733703,0.0,0,1175,fhi:git
county,Møre og Romsdal,2021-01-11,0,0,1175,0,0.442998363733703,0.0,0,1175,fhi:git
county,Møre og Romsdal,2021-01-12,228,0,1403,0,0.528958897292243,0.0,228,1403,fhi:git
county,Møre og Romsdal,2021-01-13,386,0,1789,0,0.6744885725273149,0.0,386,1789,fhi:git
county,Møre og Romsdal,2021-01-14,404,0,2193,0,0.826804605674903,0.0,404,2193,fhi:git
county,Møre og Romsdal,2021-01-15,152,0,2345,0,0.8841116280472628,0.0,152,2345,fhi:git
county,Møre og Romsdal,2021-01-16,1,0,2346,0,0.884488647931292,0.0,1,2346,fhi:git
county,Møre og Romsdal,2021-01-17,1,0,2347,0,0.8848656678153209,0.0,1,2347,fhi:git
county,Møre og Romsdal,2021-01-18,11,0,2358,0,0.889012886539636,0.0,11,2358,fhi:git
county,Møre og Romsdal,2021-01-19,163,0,2521,0,0.9504671276363119,0.0,163,2521,fhi:git
county,Møre og Romsdal,2021-01-20,488,0,3009,0,1.13445283104231,0.0,488,3009,fhi:git
county,Møre og Romsdal,2021-01-21,756,0,3765,0,1.41947986336799,0.0,756,3765,fhi:git
county,Møre og Romsdal,2021-01-22,210,0,3975,0,1.49865403901402,0.0,210,3975,fhi:git
county,Møre og Romsdal,2021-01-23,0,0,3975,0,1.49865403901402,0.0,0,3975,fhi:git
county,Møre og Romsdal,2021-01-24,0,0,3975,0,1.49865403901402,0.0,0,3975,fhi:git
county,Møre og Romsdal,2021-01-25,3,0,3978,0,1.4997850986661,0.0,3,3978,fhi:git
county,Møre og Romsdal,2021-01-26,73,127,4051,127,1.5273075502002,0.0478815252716428,200,4178,fhi:git
county,Møre og Romsdal,2021-01-27,515,336,4566,463,1.72147279047497,0.174560206305281,851,5029,fhi:git
county,Møre og Romsdal,2021-01-28,461,447,5027,910,1.89527895701219,0.343088094466102,908,5937,fhi:git
county,Møre og Romsdal,2021-01-29,78,66,5105,976,1.92468650796643,0.36797140681199497,144,6081,fhi:git
county,Møre og Romsdal,2021-01-30,0,0,5105,976,1.92468650796643,0.36797140681199497,0,6081,fhi:git
county,Møre og Romsdal,2021-01-31,0,0,5105,976,1.92468650796643,0.36797140681199497,0,6081,fhi:git
county,Møre og Romsdal,2021-02-01,0,0,5105,976,1.92468650796643,0.36797140681199497,0,6081,fhi:git
county,Møre og Romsdal,2021-02-02,190,176,5295,1152,1.9963202859318798,0.434326906401044,366,6447,fhi:git
county,Nordland,2020-12-27,0,0,0,0,0.0,0.0,0,0,fhi:git
county,Nordland,2020-12-28,0,0,0,0,0.0,0.0,0,0,fhi:git
county,Nordland,2020-12-29,0,0,0,0,0.0,0.0,0,0,fhi:git
county,Nordland,2020-12-30,0,0,0,0,0.0,0.0,0,0,fhi:git
county,Nordland,2020-12-31,0,0,0,0,0.0,0.0,0,0,fhi:git
county,Nordland,2021-01-01,0,0,0,0,0.0,0.0,0,0,fhi:git
county,Nordland,2021-01-02,0,0,0,0,0.0,0.0,0,0,fhi:git
county,Nordland,2021-01-03,0,0,0,0,0.0,0.0,0,0,fhi:git
county,Nordland,2021-01-04,0,0,0,0,0.0,0.0,0,0,fhi:git
county,Nordland,2021-01-05,200,0,200,0,0.0829067092254441,0.0,200,200,fhi:git
county,Nordland,2021-01-06,687,0,887,0,0.367691255414845,0.0,687,887,fhi:git
county,Nordland,2021-01-07,238,0,1125,0,0.46635023939312303,0.0,238,1125,fhi:git
county,Nordland,2021-01-08,115,0,1240,0,0.514021597197753,0.0,115,1240,fhi:git
county,Nordland,2021-01-09,0,0,1240,0,0.514021597197753,0.0,0,1240,fhi:git
county,Nordland,2021-01-10,0,0,1240,0,0.514021597197753,0.0,0,1240,fhi:git
county,Nordland,2021-01-11,0,0,1240,0,0.514021597197753,0.0,0,1240,fhi:git
county,Nordland,2021-01-12,291,0,1531,0,0.6346508591207739,0.0,291,1531,fhi:git
county,Nordland,2021-01-13,602,0,2133,0,0.8842000538893611,0.0,602,2133,fhi:git
county,Nordland,2021-01-14,274,0,2407,0,0.997782245528219,0.0,274,2407,fhi:git
county,Nordland,2021-01-15,69,0,2476,0,1.026385060211,0.0,69,2476,fhi:git
county,Nordland,2021-01-16,0,0,2476,0,1.026385060211,0.0,0,2476,fhi:git
county,Nordland,2021-01-17,0,0,2476,0,1.026385060211,0.0,0,2476,fhi:git
county,Nordland,2021-01-18,0,0,2476,0,1.026385060211,0.0,0,2476,fhi:git
county,Nordland,2021-01-19,313,0,2789,0,1.1561340601488201,0.0,313,2789,fhi:git
county,Nordland,2021-01-20,785,0,3574,0,1.4815428938586899,0.0,785,3574,fhi:git
county,Nordland,2021-01-21,613,0,4187,0,1.7356519576346698,0.0,613,4187,fhi:git
county,Nordland,2021-01-22,167,0,4354,0,1.80487905983792,0.0,167,4354,fhi:git
county,Nordland,2021-01-23,1,0,4355,0,1.80529359338404,0.0,1,4355,fhi:git
county,Nordland,2021-01-24,0,0,4355,0,1.80529359338404,0.0,0,4355,fhi:git
county,Nordland,2021-01-25,51,0,4406,0,1.8264348042365302,0.0,51,4406,fhi:git
county,Nordland,2021-01-26,95,90,4501,90,1.86581549111862,0.0373080191514498,185,4591,fhi:git
county,Nordland,2021-01-27,622,530,5123,620,2.12365535680975,0.257010798598877,1152,5743,fhi:git
county,Nordland,2021-01-28,467,362,5590,982,2.31724252285116,0.40707194229692995,829,6572,fhi:git
county,Nordland,2021-01-29,205,96,5795,1078,2.40222189980724,0.44686716272514393,301,6873,fhi:git
county,Nordland,2021-01-30,0,0,5795,1078,2.40222189980724,0.44686716272514393,0,6873,fhi:git
county,Nordland,2021-01-31,0,0,5795,1078,2.40222189980724,0.44686716272514393,0,6873,fhi:git
county,Nordland,2021-02-01,9,4,5804,1082,2.40595270172239,0.44852529690965204,13,6886,fhi:git
county,Nordland,2021-02-02,84,198,5888,1280,2.44077351959707,0.5306029390428421,282,7168,fhi:git
county,Viken,2020-12-27,0,0,0,0,0.0,0.0,0,0,fhi:git
county,Viken,2020-12-28,64,0,64,0,0.0051564457586219395,0.0,64,64,fhi:git
county,Viken,2020-12-29,690,0,754,0,0.0607493765937647,0.0,690,754,fhi:git
county,Viken,2020-12-30,216,0,970,0,0.0781523810291138,0.0,216,970,fhi:git
county,Viken,2020-12-31,67,0,1037,0,0.0835505351826711,0.0,67,1037,fhi:git
county,Viken,2021-01-01,0,0,1037,0,0.0835505351826711,0.0,0,1037,fhi:git
county,Viken,2021-01-02,0,0,1037,0,0.0835505351826711,0.0,0,1037,fhi:git
county,Viken,2021-01-03,0,0,1037,0,0.0835505351826711,0.0,0,1037,fhi:git
county,Viken,2021-01-04,0,0,1037,0,0.0835505351826711,0.0,0,1037,fhi:git
county,Viken,2021-01-05,522,0,1559,0,0.125607795901431,0.0,522,1559,fhi:git
county,Viken,2021-01-06,1646,0,3205,0,0.258225135255989,0.0,1646,3205,fhi:git
county,Viken,2021-01-07,1911,0,5116,0,0.412193382829841,0.0,1911,5116,fhi:git
county,Viken,2021-01-08,279,0,5395,0,0.434672263558834,0.0,279,5395,fhi:git
county,Viken,2021-01-09,6,0,5401,0,0.43515568034870505,0.0,6,5401,fhi:git
county,Viken,2021-01-10,5,0,5406,0,0.43555852767359704,0.0,5,5406,fhi:git
county,Viken,2021-01-11,55,0,5461,0,0.43998984824741294,0.0,55,5461,fhi:git
county,Viken,2021-01-12,769,0,6230,0,0.501947766815855,0.0,769,6230,fhi:git
county,Viken,2021-01-13,1927,0,8157,0,0.6572051258293621,0.0,1927,8157,fhi:git
county,Viken,2021-01-14,1944,0,10101,0,0.813832165747503,0.0,1944,10101,fhi:git
county,Viken,2021-01-15,1039,0,11140,0,0.897543839860131,0.0,1039,11140,fhi:git
county,Viken,2021-01-16,85,0,11225,0,0.9043922443833008,0.0,85,11225,fhi:git
county,Viken,2021-01-17,22,0,11247,0,0.906164772612827,0.0,22,11247,fhi:git
county,Viken,2021-01-18,141,51,11388,51,0.917525067174791,0.00410904271390186,192,11439,fhi:git
county,Viken,2021-01-19,635,380,12023,431,0.968686677436119,0.0347254394057196,1015,12454,fhi:git
county,Viken,2021-01-20,1454,339,13477,770,1.08583467951481,0.0620384880334202,1793,14247,fhi:git
county,Viken,2021-01-21,1935,98,15412,868,1.2417365942481497,0.0699342956013101,2033,16280,fhi:git
county,Viken,2021-01-22,797,1,16209,869,1.30595045783598,0.0700148650662885,798,17078,fhi:git
county,Viken,2021-01-23,97,0,16306,869,1.3137656959389,0.0700148650662885,97,17175,fhi:git
county,Viken,2021-01-24,0,0,16306,869,1.3137656959389,0.0700148650662885,0,17175,fhi:git
county,Viken,2021-01-25,59,0,16365,869,1.3185192943726298,0.0700148650662885,59,17234,fhi:git
county,Viken,2021-01-26,425,389,16790,1258,1.35276131698847,0.101356386942913,814,18048,fhi:git
county,Viken,2021-01-27,1738,1130,18528,2388,1.4927910471210502,0.19239988236858102,2868,20916,fhi:git
county,Viken,2021-01-28,3028,1613,21556,4001,1.73675538707585,0.32235842937884995,4641,25557,fhi:git
county,Viken,2021-01-29,905,416,22461,4417,1.8096707528813702,0.35587532680989203,1321,26878,fhi:git
county,Viken,2021-01-30,1,17,22462,4434,1.8097513223463402,0.357245007714526,18,26896,fhi:git
county,Viken,2021-01-31,0,3,22462,4437,1.8097513223463402,0.35748671610946203,3,26899,fhi:git
county,Viken,2021-02-01,13,45,22475,4482,1.81079872539106,0.361112342033493,58,26957,fhi:git
county,Viken,2021-02-02,838,554,23313,5036,1.87831593704302,0.405747825631564,1392,28349,fhi:git
county,Innlandet,2020-12-27,0,0,0,0,0.0,0.0,0,0,fhi:git
county,Innlandet,2020-12-28,271,0,271,0,0.07297009841539098,0.0,271,271,fhi:git
county,Innlandet,2020-12-29,260,0,531,0,0.142978310917242,0.0,260,531,fhi:git
county,Innlandet,2020-12-30,149,0,680,0,0.18309840192791801,0.0,149,680,fhi:git
county,Innlandet,2020-12-31,0,0,680,0,0.18309840192791801,0.0,0,680,fhi:git
county,Innlandet,2021-01-01,0,0,680,0,0.18309840192791801,0.0,0,680,fhi:git
county,Innlandet,2021-01-02,0,0,680,0,0.18309840192791801,0.0,0,680,fhi:git
county,Innlandet,2021-01-03,0,0,680,0,0.18309840192791801,0.0,0,680,fhi:git
county,Innlandet,2021-01-04,0,0,680,0,0.18309840192791801,0.0,0,680,fhi:git
county,Innlandet,2021-01-05,320,0,1000,0,0.269262355776351,0.0,320,1000,fhi:git
county,Innlandet,2021-01-06,651,0,1651,0,0.444552149386755,0.0,651,1651,fhi:git
county,Innlandet,2021-01-07,711,0,2362,0,0.6359976843437399,0.0,711,2362,fhi:git
county,Innlandet,2021-01-08,76,0,2438,0,0.6564616233827429,0.0,76,2438,fhi:git
county,Innlandet,2021-01-09,0,0,2438,0,0.6564616233827429,0.0,0,2438,fhi:git
county,Innlandet,2021-01-10,0,0,2438,0,0.6564616233827429,0.0,0,2438,fhi:git
county,Innlandet,2021-01-11,51,0,2489,0,0.670194003527337,0.0,51,2489,fhi:git
county,Innlandet,2021-01-12,441,0,2930,0,0.788938702424708,0.0,441,2930,fhi:git
county,Innlandet,2021-01-13,951,0,3881,0,1.04500720276802,0.0,951,3881,fhi:git
county,Innlandet,2021-01-14,940,0,4821,0,1.29811381719779,0.0,940,4821,fhi:git
county,Innlandet,2021-01-15,271,0,5092,0,1.3710839156131798,0.0,271,5092,fhi:git
county,Innlandet,2021-01-16,4,0,5096,0,1.37216096503628,0.0,4,5096,fhi:git
county,Innlandet,2021-01-17,0,0,5096,0,1.37216096503628,0.0,0,5096,fhi:git
county,Innlandet,2021-01-18,67,0,5163,0,1.3902015428733001,0.0,67,5163,fhi:git
county,Innlandet,2021-01-19,331,318,5494,318,1.47932738263527,0.0856254291368795,649,5812,fhi:git
county,Innlandet,2021-01-20,656,252,6150,570,1.65596348802456,0.15347954279252,908,6720,fhi:git
county,Innlandet,2021-01-21,826,48,6976,618,1.87837419389582,0.166404135869785,874,7594,fhi:git
county,Innlandet,2021-01-22,220,0,7196,618,1.9376119121666202,0.166404135869785,220,7814,fhi:git
county,Innlandet,2021-01-23,5,0,7201,618,1.9389582239454999,0.166404135869785,5,7819,fhi:git
county,Innlandet,2021-01-24,0,0,7201,618,1.9389582239454999,0.166404135869785,0,7819,fhi:git
county,Innlandet,2021-01-25,2,0,7203,618,1.9394967486570502,0.166404135869785,2,7821,fhi:git
county,Innlandet,2021-01-26,141,130,7344,748,1.9774627408215202,0.20140824212070998,271,8092,fhi:git
county,Innlandet,2021-01-27,896,547,8240,1295,2.21872181159713,0.3486947507303739,1443,9535,fhi:git
county,Innlandet,2021-01-28,847,699,9087,1994,2.4467870269397003,0.5369091374180429,1546,11081,fhi:git
county,Innlandet,2021-01-29,292,132,9379,2126,2.52541163482639,0.572451768380522,424,11505,fhi:git
county,Innlandet,2021-01-30,1,0,9380,2126,2.52568089718217,0.572451768380522,1,11506,fhi:git
county,Innlandet,2021-01-31,0,0,9380,2126,2.52568089718217,0.572451768380522,0,11506,fhi:git
county,Innlandet,2021-02-01,8,49,9388,2175,2.5278349960283797,0.585645623813563,57,11563,fhi:git
county,Innlandet,2021-02-02,581,304,9969,2479,2.6842764247344397,0.667501379969573,885,12448,fhi:git
county,Vestfold og Telemark,2020-12-27,0,0,0,0,0.0,0.0,0,0,fhi:git
county,Vestfold og Telemark,2020-12-28,0,0,0,0,0.0,0.0,0,0,fhi:git
county,Vestfold og Telemark,2020-12-29,0,0,0,0,0.0,0.0,0,0,fhi:git
county,Vestfold og Telemark,2020-12-30,0,0,0,0,0.0,0.0,0,0,fhi:git
county,Vestfold og Telemark,2020-12-31,0,0,0,0,0.0,0.0,0,0,fhi:git
county,Vestfold og Telemark,2021-01-01,0,0,0,0,0.0,0.0,0,0,fhi:git
county,Vestfold og Telemark,2021-01-02,0,0,0,0,0.0,0.0,0,0,fhi:git
county,Vestfold og Telemark,2021-01-03,0,0,0,0,0.0,0.0,0,0,fhi:git
county,Vestfold og Telemark,2021-01-04,0,0,0,0,0.0,0.0,0,0,fhi:git
county,Vestfold og Telemark,2021-01-05,218,0,218,0,0.0519795133954544,0.0,218,218,fhi:git
county,Vestfold og Telemark,2021-01-06,1025,0,1243,0,0.296378601608027,0.0,1025,1243,fhi:git
county,Vestfold og Telemark,2021-01-07,442,0,1685,0,0.401768257207985,0.0,442,1685,fhi:git
county,Vestfold og Telemark,2021-01-08,64,0,1749,0,0.41702829783784295,0.0,64,1749,fhi:git
county,Vestfold og Telemark,2021-01-09,0,0,1749,0,0.41702829783784295,0.0,0,1749,fhi:git
county,Vestfold og Telemark,2021-01-10,2,0,1751,0,0.417505174107526,0.0,2,1751,fhi:git
county,Vestfold og Telemark,2021-01-11,2,0,1753,0,0.417982050377209,0.0,2,1753,fhi:git
county,Vestfold og Telemark,2021-01-12,419,0,2172,0,0.517887628875812,0.0,419,2172,fhi:git
county,Vestfold og Telemark,2021-01-13,1154,0,3326,0,0.793045236482942,0.0,1154,3326,fhi:git
county,Vestfold og Telemark,2021-01-14,585,0,3911,0,0.93253154536524,0.0,585,3911,fhi:git
county,Vestfold og Telemark,2021-01-15,157,0,4068,0,0.96996633253536,0.0,157,4068,fhi:git
county,Vestfold og Telemark,2021-01-16,3,0,4071,0,0.970681646939885,0.0,3,4071,fhi:git
county,Vestfold og Telemark,2021-01-17,39,0,4110,0,0.9799807341987049,0.0,39,4110,fhi:git
county,Vestfold og Telemark,2021-01-18,5,0,4115,0,0.981172924872912,0.0,5,4115,fhi:git
county,Vestfold og Telemark,2021-01-19,226,0,4341,0,1.0350599433471,0.0,226,4341,fhi:git
county,Vestfold og Telemark,2021-01-20,1602,0,5943,0,1.41703783536324,0.0,1602,5943,fhi:git
county,Vestfold og Telemark,2021-01-21,815,0,6758,0,1.61136491525909,0.0,815,6758,fhi:git
county,Vestfold og Telemark,2021-01-22,178,0,6936,0,1.6538069032608798,0.0,178,6936,fhi:git
county,Vestfold og Telemark,2021-01-23,3,0,6939,0,1.6545222176654,0.0,3,6939,fhi:git
county,Vestfold og Telemark,2021-01-24,0,0,6939,0,1.6545222176654,0.0,0,6939,fhi:git
county,Vestfold og Telemark,2021-01-25,45,0,6984,0,1.66525193373327,0.0,45,6984,fhi:git
county,Vestfold og Telemark,2021-01-26,92,177,7076,177,1.6871882421386901,0.0422035498669515,269,7253,fhi:git
county,Vestfold og Telemark,2021-01-27,1615,897,8691,1074,2.0722658299077703,0.256082556819808,2512,9765,fhi:git
county,Vestfold og Telemark,2021-01-28,650,449,9341,1523,2.22725061755477,0.363141279363656,1099,10864,fhi:git
county,Vestfold og Telemark,2021-01-29,74,90,9415,1613,2.24489503953304,0.38460071149939395,164,11028,fhi:git
county,Vestfold og Telemark,2021-01-30,0,0,9415,1613,2.24489503953304,0.38460071149939395,0,11028,fhi:git
county,Vestfold og Telemark,2021-01-31,0,1,9415,1614,2.24489503953304,0.38483914963423604,1,11029,fhi:git
county,Vestfold og Telemark,2021-02-01,0,0,9415,1614,2.24489503953304,0.38483914963423604,0,11029,fhi:git
county,Vestfold og Telemark,2021-02-02,439,280,9854,1894,2.34956938072848,0.451601827389865,719,11748,fhi:git
county,Agder,2020-12-27,0,0,0,0,0.0,0.0,0,0,fhi:git
county,Agder,2020-12-28,0,0,0,0,0.0,0.0,0,0,fhi:git
county,Agder,2020-12-29,0,0,0,0,0.0,0.0,0,0,fhi:git
county,Agder,2020-12-30,0,0,0,0,0.0,0.0,0,0,fhi:git
county,Agder,2020-12-31,0,0,0,0,0.0,0.0,0,0,fhi:git
county,Agder,2021-01-01,0,0,0,0,0.0,0.0,0,0,fhi:git
county,Agder,2021-01-02,0,0,0,0,0.0,0.0,0,0,fhi:git
county,Agder,2021-01-03,0,0,0,0,0.0,0.0,0,0,fhi:git
county,Agder,2021-01-04,0,0,0,0,0.0,0.0,0,0,fhi:git
county,Agder,2021-01-05,79,0,79,0,0.0257135510413988,0.0,79,79,fhi:git
county,Agder,2021-01-06,791,0,870,0,0.283174549443253,0.0,791,870,fhi:git
county,Agder,2021-01-07,230,0,1100,0,0.35803678665238897,0.0,230,1100,fhi:git
county,Agder,2021-01-08,49,0,1149,0,0.37398569805781295,0.0,49,1149,fhi:git
county,Agder,2021-01-09,0,0,1149,0,0.37398569805781295,0.0,0,1149,fhi:git
county,Agder,2021-01-10,0,0,1149,0,0.37398569805781295,0.0,0,1149,fhi:git
county,Agder,2021-01-11,0,0,1149,0,0.37398569805781295,0.0,0,1149,fhi:git
county,Agder,2021-01-12,225,0,1374,0,0.44722049532762,0.0,225,1374,fhi:git
county,Agder,2021-01-13,851,0,2225,0,0.724210773001422,0.0,851,2225,fhi:git
county,Agder,2021-01-14,499,0,2724,0,0.8866292789464609,0.0,499,2724,fhi:git
county,Agder,2021-01-15,118,0,2842,0,0.9250368615146259,0.0,118,2842,fhi:git
county,Agder,2021-01-16,0,0,2842,0,0.9250368615146259,0.0,0,2842,fhi:git
county,Agder,2021-01-17,2,0,2844,0,0.9256878374903579,0.0,2,2844,fhi:git
county,Agder,2021-01-18,15,0,2859,0,0.9305701573083441,0.0,15,2859,fhi:git
county,Agder,2021-01-19,348,0,3207,0,1.04383997708565,0.0,348,3207,fhi:git
county,Agder,2021-01-20,452,0,3659,0,1.19096054760099,0.0,452,3659,fhi:git
county,Agder,2021-01-21,333,0,3992,0,1.2993480475603,0.0,333,3992,fhi:git
county,Agder,2021-01-22,55,0,4047,0,1.3172498868929199,0.0,55,4047,fhi:git
county,Agder,2021-01-23,1,0,4048,0,1.31757537488079,0.0,1,4048,fhi:git
county,Agder,2021-01-24,0,0,4048,0,1.31757537488079,0.0,0,4048,fhi:git
county,Agder,2021-01-25,1,0,4049,0,1.31790086286866,0.0,1,4049,fhi:git
county,Agder,2021-01-26,62,66,4111,66,1.3380811181163401,0.0214822071991433,128,4177,fhi:git
county,Agder,2021-01-27,535,674,4646,740,1.5122171916245402,0.240861111020698,1209,5386,fhi:git
county,Agder,2021-01-28,907,248,5553,988,1.80743479661883,0.32158213201141805,1155,6541,fhi:git
county,Agder,2021-01-29,184,61,5737,1049,1.86732458638614,0.34143689927123194,245,6786,fhi:git
county,Agder,2021-01-30,29,0,5766,1049,1.8767637380342501,0.34143689927123194,29,6815,fhi:git
county,Agder,2021-01-31,20,0,5786,1049,1.88327349779156,0.34143689927123194,20,6835,fhi:git
county,Agder,2021-02-01,0,1,5786,1050,1.88327349779156,0.34176238725909797,1,6836,fhi:git
county,Agder,2021-02-02,115,129,5901,1179,1.92070461639613,0.3837503376937871,244,7080,fhi:git
county,Vestland,2020-12-27,0,0,0,0,0.0,0.0,0,0,fhi:git
county,Vestland,2020-12-28,0,0,0,0,0.0,0.0,0,0,fhi:git
county,Vestland,2020-12-29,0,0,0,0,0.0,0.0,0,0,fhi:git
county,Vestland,2020-12-30,0,0,0,0,0.0,0.0,0,0,fhi:git
county,Vestland,2020-12-31,0,0,0,0,0.0,0.0,0,0,fhi:git
county,Vestland,2021-01-01,0,0,0,0,0.0,0.0,0,0,fhi:git
county,Vestland,2021-01-02,0,0,0,0,0.0,0.0,0,0,fhi:git
county,Vestland,2021-01-03,0,0,0,0,0.0,0.0,0,0,fhi:git
county,Vestland,2021-01-04,1,0,1,0,0.00015710153943798502,0.0,1,1,fhi:git
county,Vestland,2021-01-05,416,0,417,0,0.0655113419456397,0.0,416,417,fhi:git
county,Vestland,2021-01-06,1250,0,1667,0,0.261888266243121,0.0,1250,1667,fhi:git
county,Vestland,2021-01-07,715,0,2382,0,0.37421586694128,0.0,715,2382,fhi:git
county,Vestland,2021-01-08,139,0,2521,0,0.39605298092315994,0.0,139,2521,fhi:git
county,Vestland,2021-01-09,0,0,2521,0,0.39605298092315994,0.0,0,2521,fhi:git
county,Vestland,2021-01-10,0,0,2521,0,0.39605298092315994,0.0,0,2521,fhi:git
county,Vestland,2021-01-11,60,0,2581,0,0.40547907328943894,0.0,60,2581,fhi:git
county,Vestland,2021-01-12,853,0,3434,0,0.53948668643004,0.0,853,3434,fhi:git
county,Vestland,2021-01-13,1122,0,4556,0,0.71575461367946,0.0,1122,4556,fhi:git
county,Vestland,2021-01-14,966,0,5522,0,0.867514700776553,0.0,966,5522,fhi:git
county,Vestland,2021-01-15,421,0,5943,0,0.933654448879945,0.0,421,5943,fhi:git
county,Vestland,2021-01-16,2,0,5945,0,0.933968651958821,0.0,2,5945,fhi:git
county,Vestland,2021-01-17,1,0,5946,0,0.934125753498259,0.0,1,5946,fhi:git
county,Vestland,2021-01-18,54,0,6000,0,0.94260923662791,0.0,54,6000,fhi:git
county,Vestland,2021-01-19,367,0,6367,0,1.00026550160165,0.0,367,6367,fhi:git
county,Vestland,2021-01-20,1234,0,7601,0,1.1941288012681202,0.0,1234,7601,fhi:git
county,Vestland,2021-01-21,767,0,8368,0,1.31462568201706,0.0,767,8368,fhi:git
county,Vestland,2021-01-22,303,0,8671,0,1.36222744846677,0.0,303,8671,fhi:git
county,Vestland,2021-01-23,0,0,8671,0,1.36222744846677,0.0,0,8671,fhi:git
county,Vestland,2021-01-24,0,0,8671,0,1.36222744846677,0.0,0,8671,fhi:git
county,Vestland,2021-01-25,1,0,8672,0,1.36238455000621,0.0,1,8672,fhi:git
county,Vestland,2021-01-26,149,103,8821,103,1.38579267938247,0.0161814585621125,252,8924,fhi:git
county,Vestland,2021-01-27,1550,1169,10371,1272,1.62930006551134,0.19983315816511701,2719,11643,fhi:git
county,Vestland,2021-01-28,1875,635,12246,1907,1.9238654519575602,0.29959263570823697,2510,14153,fhi:git
county,Vestland,2021-01-29,462,164,12708,2071,1.99644636317791,0.325357288176067,626,14779,fhi:git
county,Vestland,2021-01-30,0,0,12708,2071,1.99644636317791,0.325357288176067,0,14779,fhi:git
county,Vestland,2021-01-31,0,0,12708,2071,1.99644636317791,0.325357288176067,0,14779,fhi:git
county,Vestland,2021-02-01,13,58,12721,2129,1.9984886831906101,0.33446917746346994,71,14850,fhi:git
county,Vestland,2021-02-02,627,542,13348,2671,2.09699134841822,0.419618211838858,1169,16019,fhi:git
county,Trøndelag,2020-12-27,0,0,0,0,0.0,0.0,0,0,fhi:git
county,Trøndelag,2020-12-28,0,0,0,0,0.0,0.0,0,0,fhi:git
county,Trøndelag,2020-12-29,0,0,0,0,0.0,0.0,0,0,fhi:git
county,Trøndelag,2020-12-30,0,0,0,0,0.0,0.0,0,0,fhi:git
county,Trøndelag,2020-12-31,0,0,0,0,0.0,0.0,0,0,fhi:git
county,Trøndelag,2021-01-01,0,0,0,0,0.0,0.0,0,0,fhi:git
county,Trøndelag,2021-01-02,0,0,0,0,0.0,0.0,0,0,fhi:git
county,Trøndelag,2021-01-03,0,0,0,0,0.0,0.0,0,0,fhi:git
county,Trøndelag,2021-01-04,0,0,0,0,0.0,0.0,0,0,fhi:git
county,Trøndelag,2021-01-05,411,0,411,0,0.0876889793514856,0.0,411,411,fhi:git
county,Trøndelag,2021-01-06,674,0,1085,0,0.231490371280686,0.0,674,1085,fhi:git
county,Trøndelag,2021-01-07,482,0,1567,0,0.334327568476345,0.0,482,1567,fhi:git
county,Trøndelag,2021-01-08,140,0,1707,0,0.364197293802885,0.0,140,1707,fhi:git
county,Trøndelag,2021-01-09,0,0,1707,0,0.364197293802885,0.0,0,1707,fhi:git
county,Trøndelag,2021-01-10,0,0,1707,0,0.364197293802885,0.0,0,1707,fhi:git
county,Trøndelag,2021-01-11,95,0,1802,0,0.384466035988752,0.0,95,1802,fhi:git
county,Trøndelag,2021-01-12,500,0,2302,0,0.491143626440681,0.0,500,2302,fhi:git
county,Trøndelag,2021-01-13,863,0,3165,0,0.67526914756071,0.0,863,3165,fhi:git
county,Trøndelag,2021-01-14,666,0,3831,0,0.81736369804268,0.0,666,3831,fhi:git
county,Trøndelag,2021-01-15,253,0,4084,0,0.871342558811356,0.0,253,4084,fhi:git
county,Trøndelag,2021-01-16,0,0,4084,0,0.871342558811356,0.0,0,4084,fhi:git
county,Trøndelag,2021-01-17,0,0,4084,0,0.871342558811356,0.0,0,4084,fhi:git
county,Trøndelag,2021-01-18,155,0,4239,0,0.904412611851454,0.0,155,4239,fhi:git
county,Trøndelag,2021-01-19,568,0,4807,0,1.02559835460484,0.0,568,4807,fhi:git
county,Trøndelag,2021-01-20,734,0,5541,0,1.18220105738828,0.0,734,5541,fhi:git
county,Trøndelag,2021-01-21,495,0,6036,0,1.28781187193569,0.0,495,6036,fhi:git
county,Trøndelag,2021-01-22,284,0,6320,0,1.34840474331238,0.0,284,6320,fhi:git
county,Trøndelag,2021-01-23,1,0,6321,0,1.3486180984932898,0.0,1,6321,fhi:git
county,Trøndelag,2021-01-24,0,0,6321,0,1.3486180984932898,0.0,0,6321,fhi:git
county,Trøndelag,2021-01-25,1,0,6322,0,1.34883145367419,0.0,1,6322,fhi:git
county,Trøndelag,2021-01-26,314,184,6636,184,1.415824980478,0.0392573532863098,498,6820,fhi:git
county,Trøndelag,2021-01-27,963,592,7599,776,1.62128601968842,0.16556362038139402,1555,8375,fhi:git
county,Trøndelag,2021-01-28,697,467,8296,1243,1.7699945807784099,0.265200489863495,1164,9539,fhi:git
county,Trøndelag,2021-01-29,382,197,8678,1440,1.85149625988368,0.307231460501555,579,10118,fhi:git
county,Trøndelag,2021-01-30,0,0,8678,1440,1.85149625988368,0.307231460501555,0,10118,fhi:git
county,Trøndelag,2021-01-31,0,1,8678,1441,1.85149625988368,0.307444815682459,1,10119,fhi:git
county,Trøndelag,2021-02-01,3,86,8681,1527,1.8521363254263898,0.32579336124019104,89,10208,fhi:git
county,Trøndelag,2021-02-02,786,341,9467,1868,2.01983349761682,0.39854747792840706,1127,11335,fhi:git
county,Troms og Finnmark,2020-12-27,0,0,0,0,0.0,0.0,0,0,fhi:git
county,Troms og Finnmark,2020-12-28,1,0,1,0,0.00041099662571770297,0.0,1,1,fhi:git
county,Troms og Finnmark,2020-12-29,0,0,1,0,0.00041099662571770297,0.0,0,1,fhi:git
county,Troms og Finnmark,2020-12-30,0,0,1,0,0.00041099662571770297,0.0,0,1,fhi:git
county,Troms og Finnmark,2020-12-31,0,0,1,0,0.00041099662571770297,0.0,0,1,fhi:git
county,Troms og Finnmark,2021-01-01,0,0,1,0,0.00041099662571770297,0.0,0,1,fhi:git
county,Troms og Finnmark,2021-01-02,0,0,1,0,0.00041099662571770297,0.0,0,1,fhi:git
county,Troms og Finnmark,2021-01-03,0,0,1,0,0.00041099662571770297,0.0,0,1,fhi:git
county,Troms og Finnmark,2021-01-04,0,0,1,0,0.00041099662571770297,0.0,0,1,fhi:git
county,Troms og Finnmark,2021-01-05,53,0,54,0,0.022193817788756,0.0,53,54,fhi:git
county,Troms og Finnmark,2021-01-06,529,0,583,0,0.23961103279342102,0.0,529,583,fhi:git
county,Troms og Finnmark,2021-01-07,188,0,771,0,0.31687839842834903,0.0,188,771,fhi:git
county,Troms og Finnmark,2021-01-08,247,0,1018,0,0.418394564980622,0.0,247,1018,fhi:git
county,Troms og Finnmark,2021-01-09,0,0,1018,0,0.418394564980622,0.0,0,1018,fhi:git
county,Troms og Finnmark,2021-01-10,0,0,1018,0,0.418394564980622,0.0,0,1018,fhi:git
county,Troms og Finnmark,2021-01-11,1,0,1019,0,0.41880556160633897,0.0,1,1019,fhi:git
county,Troms og Finnmark,2021-01-12,188,0,1207,0,0.49607292724126706,0.0,188,1207,fhi:git
county,Troms og Finnmark,2021-01-13,575,0,1782,0,0.732395987028947,0.0,575,1782,fhi:git
county,Troms og Finnmark,2021-01-14,329,0,2111,0,0.8676138768900709,0.0,329,2111,fhi:git
county,Troms og Finnmark,2021-01-15,37,0,2148,0,0.882820752041626,0.0,37,2148,fhi:git
county,Troms og Finnmark,2021-01-16,2,0,2150,0,0.8836427452930609,0.0,2,2150,fhi:git
county,Troms og Finnmark,2021-01-17,1,0,2151,0,0.8840537419187791,0.0,1,2151,fhi:git
county,Troms og Finnmark,2021-01-18,0,1,2151,1,0.8840537419187791,0.00041099662571770297,1,2152,fhi:git
county,Troms og Finnmark,2021-01-19,248,0,2399,1,0.9859809050967691,0.00041099662571770297,248,2400,fhi:git
county,Troms og Finnmark,2021-01-20,908,0,3307,1,1.3591658412484398,0.00041099662571770297,908,3308,fhi:git
county,Troms og Finnmark,2021-01-21,247,0,3554,1,1.46068200780072,0.00041099662571770297,247,3555,fhi:git
county,Troms og Finnmark,2021-01-22,81,0,3635,1,1.49397273448385,0.00041099662571770297,81,3636,fhi:git
county,Troms og Finnmark,2021-01-23,12,0,3647,1,1.4989046939924602,0.00041099662571770297,12,3648,fhi:git
county,Troms og Finnmark,2021-01-24,0,0,3647,1,1.4989046939924602,0.00041099662571770297,0,3648,fhi:git
county,Troms og Finnmark,2021-01-25,6,0,3653,1,1.50137067374677,0.00041099662571770297,6,3654,fhi:git
county,Troms og Finnmark,2021-01-26,71,0,3724,1,1.5305514341727298,0.00041099662571770297,71,3725,fhi:git
county,Troms og Finnmark,2021-01-27,664,360,4388,361,1.8034531936492801,0.148369781884091,1024,4749,fhi:git
county,Troms og Finnmark,2021-01-28,229,266,4617,627,1.8975714209386298,0.257694884325,495,5244,fhi:git
county,Troms og Finnmark,2021-01-29,102,243,4719,870,1.93949307676184,0.357567064374401,345,5589,fhi:git
county,Troms og Finnmark,2021-01-30,0,0,4719,870,1.93949307676184,0.357567064374401,0,5589,fhi:git
county,Troms og Finnmark,2021-01-31,0,0,4719,870,1.93949307676184,0.357567064374401,0,5589,fhi:git
county,Troms og Finnmark,2021-02-01,0,2,4719,872,1.93949307676184,0.358389057625837,2,5591,fhi:git
county,Troms og Finnmark,2021-02-02,72,7,4791,879,1.9690848338135098,0.36126603400586105,79,5670,fhi:git
nation,Norge,2020-12-27,5,0,5,0,9.31518486915891e-05,0.0,5,5,fhi:git
nation,Norge,2020-12-28,600,0,605,0,0.0112713736916823,0.0,600,605,fhi:git
nation,Norge,2020-12-29,1068,0,1673,0,0.0311686085722057,0.0,1068,1673,fhi:git
nation,Norge,2020-12-30,423,0,2096,0,0.0390492549715142,0.0,423,2096,fhi:git
nation,Norge,2020-12-31,72,0,2168,0,0.0403906415926731,0.0,72,2168,fhi:git
nation,Norge,2021-01-01,6,0,2174,0,0.040502423811103,0.0,6,2174,fhi:git
nation,Norge,2021-01-02,0,0,2174,0,0.040502423811103,0.0,0,2174,fhi:git
nation,Norge,2021-01-03,0,0,2174,0,0.040502423811103,0.0,0,2174,fhi:git
nation,Norge,2021-01-04,1,0,2175,0,0.0405210541808413,0.0,1,2175,fhi:git
nation,Norge,2021-01-05,3435,0,5610,0,0.10451637423196301,0.0,3435,5610,fhi:git
nation,Norge,2021-01-06,9006,0,14616,0,0.272301484095253,0.0,9006,14616,fhi:git
nation,Norge,2021-01-07,6553,0,21169,0,0.39438629699045,0.0,6553,21169,fhi:git
nation,Norge,2021-01-08,1614,0,22783,0,0.424455713748095,0.0,1614,22783,fhi:git
nation,Norge,2021-01-09,132,0,22915,0,0.426914922553553,0.0,132,22915,fhi:git
nation,Norge,2021-01-10,107,0,23022,0,0.42890837211555294,0.0,107,23022,fhi:git
nation,Norge,2021-01-11,342,0,23364,0,0.435279958566058,0.0,342,23364,fhi:git
nation,Norge,2021-01-12,4283,0,27647,0,0.5150738321552729,0.0,4283,27647,fhi:git
nation,Norge,2021-01-13,9684,0,37331,0,0.6954903327011429,0.0,9684,37331,fhi:git
nation,Norge,2021-01-14,8376,0,45707,0,0.8515383096292929,0.0,8376,45707,fhi:git
nation,Norge,2021-01-15,4469,0,50176,0,0.9347974319898349,0.0,4469,50176,fhi:git
nation,Norge,2021-01-16,729,0,50905,0,0.9483789715290691,0.0,729,50905,fhi:git
nation,Norge,2021-01-17,344,5,51249,5,0.9547878187190499,9.31518486915891e-05,349,51254,fhi:git
nation,Norge,2021-01-18,1259,283,52508,288,0.978243454219592,0.005365546484635529,1542,52796,fhi:git
nation,Norge,2021-01-19,4523,767,57031,1055,1.062508616546,0.0196550400739253,5290,58086,fhi:git
nation,Norge,2021-01-20,9925,690,66956,1745,1.2474150361988101,0.0325099951933646,10615,68701,fhi:git
nation,Norge,2021-01-21,8231,167,75187,1912,1.4007616095148998,0.0356212669396637,8398,77099,fhi:git
nation,Norge,2021-01-22,3232,7,78419,1919,1.4609749645091499,0.0357516795278319,3239,80338,fhi:git
nation,Norge,2021-01-23,353,0,78772,1919,1.46755148502677,0.0357516795278319,353,80691,fhi:git
nation,Norge,2021-01-24,65,0,78837,1919,1.4687624590597599,0.0357516795278319,65,80756,fhi:git
nation,Norge,2021-01-25,574,0,79411,1919,1.4794562912895601,0.0357516795278319,574,81330,fhi:git
nation,Norge,2021-01-26,2035,2051,81446,3970,1.51736909370703,0.0739625678611218,4086,85416,fhi:git
nation,Norge,2021-01-27,10891,7363,92337,11333,1.7202724505270501,0.211137980244356,18254,103670,fhi:git
nation,Norge,2021-01-28,10482,6313,102819,17646,1.9155559861241,0.328751504402356,16795,120465,fhi:git
nation,Norge,2021-01-29,3450,1988,106269,19634,1.9798307617213002,0.36578867944213206,5438,125903,fhi:git
nation,Norge,2021-01-30,111,164,106380,19798,1.98189873276225,0.368844060079216,275,126178,fhi:git
nation,Norge,2021-01-31,80,49,106460,19847,1.9833891623413202,0.369756948196394,129,126307,fhi:git
nation,Norge,2021-02-01,110,297,106570,20144,1.9854385030125299,0.375290168008674,407,126714,fhi:git
nation,Norge,2021-02-02,5510,2750,112080,22894,2.08809184027066,0.426523684789048,8260,134974,fhi:git
